1111111111111111111111111111111
1...........1...........M.....1
1..P........1.................1
1..1111111..1..1111111111..1..1
1..1.....1.....1.....1.....1..1
1..1.....1.....1.....1.....1..1
1..1..1..1..1111111..1..1111111
1..1..1..1..1........1........1
1..1..1..1..1........1........1
1..1..1..1..1..1111111111111..1
1.....1..1.....1........1.....1
1.....1..1.....1.....M..1.....1
1111111..1111111..1111..1..1111
1..1.....1........1.....1.....1
1..1.....1........1.....1.....1
1..1..1111..1111111..1111111..1
1...M.1.....1..1.....1........1
1.....1.....1..1.....1........1
1..1111111..1..1..1111..1111..1
1........1..1..1..M.....1..1..1
1....M...1..1..1........1..1..1
1111111..1..1..1111111111..1..1
1..1.....1..1..............1..1
1..1.....1..1..............1..1
1..1..1111..1..1111111..1..1..1
1..1........1.....1W.1..1..1..1
1..1........1.....1..1..1..1..1
1..1111111111111..1111..1111..1
1..........M.........1........1
1....................1......M.1
1111111111111111111111111111111