111111111111111111111111111111111
1....1..1..........1...1........1
1....1..1.......11..1...........1
1..........11......11.....1.....1
1...........11111111....1111.1111
11111..................1....1...1
1.......1..............1...1....1
1......................1..1.....1
111111......111111111111........1
1.............1.................1
1.....1.......1...........1111..1
1.....1.......1.........11......1
1.....1.............1111........1
1.....1...........11.......111111
1....11111..111111........1..1..1
1....1.......1..........11......1
1....1.......1......1111......1.1
1....1.......1...111.....1.....11
1....1.......1...1...11111..1...1
1....1.......1......1.....1111..1
111111....11111....1..111.......1
1........1....1..111......11111.1
1.......1.....1111....111.....1W1
1......1......1..1............1.1
1..1111.......1111..1.1.......111
1.....1.......1..1..111.........1
1.....1...11.....1111..11111111.1
1..........1....................1
1111111111111E1111111111111111111